Aquila_chrysaetos	Accipitriformes
Haliaeetus_leucocephalus	Accipitriformes
Haliaeetus_albicilla	Accipitriformes
Circaetus_pectoralis	Accipitriformes
Spizaetus_tyrannus	Accipitriformes
Cathartes_aura	Accipitriformes
Pandion_haliaetus	Accipitriformes
Sagittarius_serpentarius	Accipitriformes
Anas_platyrhynchos	Anseriformes
Anas_zonorhyncha	Anseriformes
Anser_cygnoid	Anseriformes
Cairina_moschata	Anseriformes
Asarcornis_scutulata	Anseriformes
Chauna_torquata	Anseriformes
Anseranas_semipalmata	Anseriformes
Apteryx_australis	Apterygiformes
Apteryx_haastii	Apterygiformes
Apteryx_owenii	Apterygiformes
Apteryx_rowi	Apterygiformes
Bucorvus_abyssinicus	Bucerotiformes
Buceros_rhinoceros	Bucerotiformes
Rhinopomastus_cyanomelas	Bucerotiformes
Upupa_epops	Bucerotiformes
Aegotheles_bennettii	Caprimulgiformes1
Hemiprocne_comata	Caprimulgiformes1
Chaetura_pelagica	Caprimulgiformes1
Antrostomus_carolinensis	Caprimulgidae
Nyctiprogne_leucopyga	Caprimulgidae
Chordeiles_acutipennis	Caprimulgidae
Nyctibius_grandis	Nyctibiidae
Nyctibius_bracteatus	Nyctibiidae
Podargus_strigoides	Caprimulgiformes1
Steatornis_caripensis	Steatornithidae
Calypte_anna	Caprimulgiformes1
Oreotrochilus_melanogaster	Caprimulgiformes1
Cariama_cristata	Cariamiformes
Chunga_burmeisteri	Cariamiformes
Casuarius_casuarius	Casuariiformes
Dromaius_novaehollandiae	Casuariiformes
Alca_torda	Charadriiformes
Uria_aalge	Charadriiformes
Cepphus_grylle	Charadriiformes
Uria_lomvia	Charadriiformes
Burhinus_bistriatus	Charadriiformes
Charadrius_vociferus	Charadriiformes
Charadrius_alexandrinus	Charadriiformes
Chionis_minor	Charadriiformes
Pluvianellus_socialis	Charadriiformes
Dromas_ardeola	Charadriiformes
Rhinoptilus_africanus	Charadriiformes
Glareola_pratincola	Charadriiformes
Ibidorhyncha_struthersii	Charadriiformes
Jacana_jacana	Charadriiformes
Rissa_tridactyla	Charadriiformes
Rynchops_niger	Charadriiformes
Chroicocephalus_maculipennis	Charadriiformes
Larus_smithsonianus	Charadriiformes
Phaetusa_simplex	Charadriiformes
Pedionomus_torquatus	Charadriiformes
Himantopus_himantopus	Charadriiformes
Nycticryphes_semicollaris	Charadriiformes
Rostratula_benghalensis	Charadriiformes
Arenaria_interpres	Charadriiformes
Limosa_lapponica	Charadriiformes
Calidris_pugnax	Charadriiformes
Stercorarius_parasiticus	Charadriiformes
Thinocorus_orbignyianus	Charadriiformes
Turnix_velox	Charadriiformes
Colius_striatus	Coliiformes
Urocolius_indicus	Coliiformes
Patagioenas_fasciata	Columbiformes
Columba_livia	Columbiformes
Alopecoenas_beccarii	Columbiformes
Columbina_picui	Columbiformes
Caloenas_nicobarica	Columbiformes
Chloroceryle_aenea	Coraciiformes
Ceyx_cyanopectus	Coraciiformes
Halcyon_senegalensis	Coraciiformes
Brachypteracias_leptosomus	Coraciiformes
Eurystomus_gularis	Coraciiformes
Merops_nubicus	Coraciiformes
Baryphthengus_martii	Coraciiformes
Todus_mexicanus	Coraciiformes
Cuculus_canorus	Cuculiformes
Crotophaga_sulcirostris	Cuculiformes
Geococcyx_californianus	Cuculiformes
Centropus_bengalensis	Cuculiformes
Centropus_unirufus	Cuculiformes
Ceuthmochares_aereus	Cuculiformes
Piaya_cayana	Cuculiformes
Eurypyga_helias	Eurypygiformes
Rhynochetos_jubatus	Eurypygiformes
Falco_cherrug	Falconiformes
Falco_peregrinus	Falconiformes
Herpetotheres_cachinnans	Falconiformes
Penelope_pileata	Galliformes
Alectura_lathami	Galliformes
Numida_meleagris	Galliformes
Callipepla_squamata	Galliformes
Colinus_virginianus	Galliformes
Odontophorus_gujanensis	Galliformes
Coturnix_japonica	Galliformes
Gallus_gallus	Galliformes
Meleagris_gallopavo	Galliformes
Phasianus_colchicus	Galliformes
Tympanuchus_cupido	Galliformes
Gavia_stellata	Gaviiformes
Aramus_guarauna	Gruiformes
Balearica_regulorum	Gruiformes
Grus_americana	Gruiformes
Heliornis_fulica	Gruiformes
Psophia_crepitans	Gruiformes
Atlantisia_rogersi	Gruiformes
Zapornia_atra	Gruiformes
Leptosomus_discolor	Leptosomatiformes
Mesitornis_unicolor	Mesitornithiformes
Tauraco_erythrolophus	Musophagiformes
Corythaeola_cristata	Musophagiformes
Corythaixoides_concolor	Musophagiformes
Opisthocomus_hoazin	Opisthocomiformes
Chlamydotis_macqueenii	Otidiformes
Ardeotis_kori	Otidiformes
Lophotis_ruficrista	Otidiformes
Acanthisitta_chloris	Passeriformes
Origma_solitaria	Passeriformes
Hippolais_icterina	Passeriformes
Acrocephalus_arundinaceus	Passeriformes
Aegithalos_caudatus	Passeriformes
Alaudala_cheleensis	Passeriformes
Gymnorhina_tibicen	Passeriformes
Atrichornis_clamosus	Passeriformes
Oxylabes_madagascariensis	Passeriformes
Bombycilla_garrulus	Passeriformes
Buphagus_erythrorhynchus	Passeriformes
Callaeas_wilsoni	Passeriformes
Smithornis_capensis	Passeriformes
Calyptomena_viridis	Passeriformes
Edolisoma_coerulescens	Passeriformes
Passerina_amoena	Passeriformes
Pheucticus_melanocephalus	Passeriformes
Cardinalis_cardinalis	Passeriformes
Certhia_brachydactyla	Passeriformes
Certhia_familiaris	Passeriformes
Cinclus_mexicanus	Passeriformes
Ptilorrhoa_leucosticta	Passeriformes
Cisticola_juncidis	Passeriformes
Climacteris_rufus	Passeriformes
Cnemophilus_loriae	Passeriformes
Struthidea_cinerea	Passeriformes
Aphelocoma_coerulescens	Passeriformes
Corvus_brachyrhynchos	Passeriformes
Corvus_cornix	Passeriformes
Corvus_moneduloides	Passeriformes
Cephalopterus_ornatus	Passeriformes
Dasyornis_broadbenti	Passeriformes
Campylorhamphus_procurvoides	Passeriformes
Dicaeum_eximium	Passeriformes
Dicrurus_megarhynchus	Passeriformes
Donacobius_atricapilla	Passeriformes
Melospiza_melodia	Passeriformes
Junco_hyemalis	Passeriformes
Emberiza_fucata	Passeriformes
Zonotrichia_albicollis	Passeriformes
Lonchura_striata	Passeriformes
Taeniopygia_guttata	Passeriformes
Eulacestoma_nigropectus	Passeriformes
Picathartes_gymnocephalus	Passeriformes
Chaetops_frenatus	Passeriformes
Serilophus_lunatus	Passeriformes
Falcunculus_frontatus	Passeriformes
Formicarius_rufipectus	Passeriformes
Loxia_curvirostra	Passeriformes
Chlorodrepanis_virens	Passeriformes
Hemignathus_wilsoni	Passeriformes
Loxia_leucoptera	Passeriformes
Serinus_canaria	Passeriformes
Furnarius_figulus	Passeriformes
Xiphorhynchus_elegans	Passeriformes
Grallaria_varia	Passeriformes
Hirundo_rustica	Passeriformes
Molothrus_ater	Passeriformes
Agelaius_phoeniceus	Passeriformes
Quiscalus_mexicanus	Passeriformes
Ifrita_kowaldi	Passeriformes
Irena_cyanogastra	Passeriformes
Chloropsis_cyanopogon	Passeriformes
Chloropsis_hardwickii	Passeriformes
Lanius_ludovicianus	Passeriformes
Leiothrix_lutea	Passeriformes
Locustella_ochotensis	Passeriformes
Machaerirhynchus_nigripectus	Passeriformes
Sylvietta_virens	Passeriformes
Dryoscopus_gambensis	Passeriformes
Malurus_elegans	Passeriformes
Melanocharis_versteri	Passeriformes
Grantiella_picta	Passeriformes
Menura_novaehollandiae	Passeriformes
Toxostoma_redivivum	Passeriformes
Mohoua_ochrocephala	Passeriformes
Myiagra_hebetior	Passeriformes
Motacilla_alba	Passeriformes
Erithacus_rubecula	Passeriformes
Cercotrichas_coryphaeus	Passeriformes
Ficedula_albicollis	Passeriformes
Oenanthe_oenanthe	Passeriformes
Saxicola_maurus	Passeriformes
Copsychus_sechellarum	Passeriformes
Leptocoma_aspasia	Passeriformes
Daphoenositta_chrysoptera	Passeriformes
Nicator_chloris	Passeriformes
Notiomystis_cincta	Passeriformes
Onychorhynchus_coronatus	Passeriformes
Aleadryas_rufinucha	Passeriformes
Oriolus_oriolus	Passeriformes
Orthonyx_spaldingii	Passeriformes
Oxyruncus_cristatus	Passeriformes
Pachycephala_philippinensis	Passeriformes
Panurus_biarmicus	Passeriformes
Paradisaea_raggiana	Passeriformes
Oreocharis_arfaki	Passeriformes
Pardalotus_punctatus	Passeriformes
Poecile_atricapillus	Passeriformes
Parus_major	Passeriformes
Pseudopodoces_humilis	Passeriformes
Setophaga_coronata	Passeriformes
Setophaga_kirtlandii	Passeriformes
Spizella_passerina	Passeriformes
Passer_domesticus	Passeriformes
Hypocryptadius_cinnamomeus	Passeriformes
Illadopsis_cleaveri	Passeriformes
Drymodes_brunneopygia	Passeriformes
Peucedramus_taeniatus	Passeriformes
Neodrepanis_coruscans	Passeriformes
Phylloscopus_trochilus	Passeriformes
Rhadina_sibilatrix	Passeriformes
Lepidothrix_coronata	Passeriformes
Manacus_manacus	Passeriformes
Piprites_chloris	Passeriformes
Mionectes_macconnelli	Passeriformes
Pitta_sordida	Passeriformes
Neopipo_cinnamomea	Passeriformes
Dyaphorophyia_castanea	Passeriformes
Calcarius_ornatus	Passeriformes
Ploceus_nigricollis	Passeriformes
Polioptila_caerulea	Passeriformes
Pomatostomus_ruficeps	Passeriformes
Promerops_cafer	Passeriformes
Prunella_fulvescens	Passeriformes
Prunella_himalayana	Passeriformes
Phainopepla_nitens	Passeriformes
Ptilonorhynchus_violaceus	Passeriformes
Brachypodius_atriceps	Passeriformes
Pycnonotus_jocosus	Passeriformes
Regulus_satrapa	Passeriformes
Anthoscopus_minutus	Passeriformes
Rhagologus_leucostigma	Passeriformes
Scytalopus_superciliaris	Passeriformes
Rhipidura_dahli	Passeriformes
Chaetorhynchus_papuensis	Passeriformes
Rhodinocichla_rosea	Passeriformes
Sapayoa_aenigma	Passeriformes
Sclerurus_mexicanus	Passeriformes
Erythrocercus_mccallii	Passeriformes
Horornis_vulcanius	Passeriformes
Cettia_cetti	Passeriformes
Hylia_prasina	Passeriformes
Sitta_europaea	Passeriformes
Tichodroma_muraria	Passeriformes
Sturnus_vulgaris	Passeriformes
Rhabdornis_inornatus	Passeriformes
Leucopsar_rothschildi	Passeriformes
Sylvia_atricapilla	Passeriformes
Sylvia_borin	Passeriformes
Sinosuthora_webbiana	Passeriformes
Tachuris_rubrigastra	Passeriformes
Rhegmatorhina_hoffmannsi	Passeriformes
Sakesphorus_luctuosus	Passeriformes
Geospiza_fortis	Passeriformes
Nesospiza_acunhae	Passeriformes
Sporophila_hypoxantha	Passeriformes
Elachura_formosa	Passeriformes
Pomatorhinus_ruficollis	Passeriformes
Pachyramphus_minor	Passeriformes
Thryothorus_ludovicianus	Passeriformes
Catharus_fuscescens	Passeriformes
Tyrannus_savana	Passeriformes
Urocynchramus_pylzowi	Passeriformes
Mystacornis_crossleyi	Passeriformes
Vidua_chalybeata	Passeriformes
Vidua_macroura	Passeriformes
Vireo_altiloquus	Passeriformes
Erpornis_zantholeuca	Passeriformes
Pteruthius_melanotis	Passeriformes
Sterrhoptilus_dennistouni	Passeriformes
Zosterops_hypoxanthus	Passeriformes
Zosterops_lateralis	Passeriformes
Anhinga_anhinga	Pelecaniformes
Anhinga_rufa	Pelecaniformes
Egretta_garzetta	Pelecaniformes
Cochlearius_cochlearius	Pelecaniformes
Balaeniceps_rex	Pelecaniformes
Ciconia_maguari	Pelecaniformes
Fregata_magnificens	Pelecaniformes
Pelecanus_crispus	Pelecaniformes
Phalacrocorax_auritus	Pelecaniformes
Phalacrocorax_brasilianus	Pelecaniformes
Phalacrocorax_carbo	Pelecaniformes
Phalacrocorax_harrisi	Pelecaniformes
Phalacrocorax_pelagicus	Pelecaniformes
Scopus_umbretta	Pelecaniformes
Sula_dactylatra	Pelecaniformes
Mesembrinibis_cayennensis	Pelecaniformes
Nipponia_nippon	Pelecaniformes
Phaethon_lepturus	Phaethontiformes
Phoenicopterus_ruber	Phoenicopteriformes_f
Podiceps_cristatus	Phoenicopteriformes_g
Podilymbus_podiceps	Phoenicopteriformes_g
Bucco_capensis	Piciformes
Galbula_dea	Piciformes
Indicator_maculatus	Piciformes
Picoides_pubescens	Piciformes
Tricholaema_leucomelas	Piciformes
Psilopogon_haemacephalus	Piciformes
Eubucco_bourcierii	Piciformes
Semnornis_frantzii	Piciformes
Ramphastos_sulfuratus	Piciformes
Thalassarche_chlororhynchos	Procellariiformes
Hydrobates_tethys	Procellariiformes
Fregetta_grallaria	Procellariiformes
Oceanites_oceanicus	Procellariiformes
Calonectris_borealis	Procellariiformes
Fulmarus_glacialis	Procellariiformes
Pelecanoides_urinatrix	Procellariiformes
Eolophus_roseicapillus	Psittaciformes
Probosciger_aterrimus	Psittaciformes
Amazona_guildingii	Psittaciformes
Agapornis_roseicollis	Psittaciformes
Melopsittacus_undulatus	Psittaciformes
Nestor_notabilis	Psittaciformes
Pterocles_gutturalis	Pterocliformes
Syrrhaptes_paradoxus	Pterocliformes
Pterocles_burchelli	Pterocliformes
Rhea_americana	Rheiformes
Rhea_pennata	Rheiformes
Aptenodytes_forsteri	Sphenisciformes
Pygoscelis_adeliae	Sphenisciformes
Strix_occidentalis	Strigiformes
Ciccaba_nigrolineata	Strigiformes
Glaucidium_brasilianum	Strigiformes
Tyto_alba	Strigiformes
Struthio_camelus	Struthioniformes
Crypturellus_cinnamomeus	Tinamiformes
Crypturellus_soui	Tinamiformes
Crypturellus_undulatus	Tinamiformes
Nothocercus_julius	Tinamiformes
Nothocercus_nigrocapillus	Tinamiformes
Tinamus_guttatus	Tinamiformes
Nothoprocta_perdicaria	Tinamiformes
Eudromia_elegans	Tinamiformes
Nothoprocta_ornata	Tinamiformes
Nothoprocta_pentlandii	Tinamiformes
Apaloderma_vittatum	Trogoniformes
Trogon_melanurus	Trogoniformes
